1 1 1 1 1 1 1 1 1 1 1 
1 A A A A A A A 1 1 1
1 0 0 0 0 0 0 0 1 D 1
1 + 0 0 0 0 0 0 B D 1
1 + + 0 0 0 0 0 1 D 1
1 + 0 0 0 0 0 0 C D 1
1 0 0 0 0 0 0 0 1 D 1
1 A A A A A A A 1 1 1
1 1 1 1 1 1 1 1 1 1 1
