1 1 1 1 1 1 1 1 1 1 1 1 
1 0 0 0 0 0 0 0 0 0 0 1
1 A A 1 0 + 0 + 1 B B 1
1 0 0 1 0 0 0 0 1 0 0 1
1 0 0 1 0 + 0 + 1 0 0 1
1 0 0 1 0 0 0 0 1 0 0 1
1 0 0 1 C C C C 1 0 0 1
1 0 0 1 1 1 1 1 1 0 0 1
1 0 0 0 0 0 0 0 0 0 0 1
1 0 0 0 0 0 0 0 0 0 0 1
1 D D D D D D D D D D 1
1 1 1 1 1 1 1 1 1 1 1 1
