1 1 1 1 1 1 1 1 1 1 1 1 
1 0 0 0 0 B B 0 0 0 0 1
1 0 0 0 0 0 0 0 0 0 0 1
1 0 0 0 0 0 0 0 0 0 0 1
1 0 0 0 1 1 1 1 1 0 0 1
1 0 0 0 C C C C 1 0 0 1
1 0 0 0 0 0 0 0 1 0 0 1
1 0 0 0 0 0 0 0 1 + + 1
1 1 1 1 1 0 0 0 1 A A 1
1 1 1 1 1 0 0 0 1 1 1 1
1 D D D D D D D D D D 1
1 1 1 1 1 1 1 1 1 1 1 1
